111111111
1w0000001
101111111
100000011
101111111
100000001
111110111
00000000w