111111111
10000000x
101111111
100000011
101111111
100000001
111110001
w00000000