111111111
1w0000001
111111101
100000001
101111111
100000001
111111111
w00000000